ID;Code du département;Libellé du département;Inscrits;Votants;Exprimés;Abstentions;Blancs et nuls;Marine LE PEN (RN);Emmanuel MACRON (LREM);Jean-Luc MÉLENCHON (LFI);François FILLON (LR);Benoît HAMON (PS);Nicolas DUPONT-AIGNAN (DLF);Jean LASSALLE (R);Philippe POUTOU (NPA);François ASSELINEAU (UPR);Nathalie ARTHAUD (LO);Jacques CHEMINADE (SP)
1;1;AIN;415886;334379;325799;81507;8580;81455;73692;51736;69805;16711;19788;3465;3098;3612;1842;595
2;2;AISNE;375752;295569;288140;80183;7429;102770;51680;48950;46969;12230;14651;2264;3156;2171;2763;536
3;3;ALLIER;253508;199233;192460;54275;6773;43004;45651;38311;36457;10619;9795;2986;2322;1422;1540;353
4;4;ALPES-DE-HAUTE-PROVENCE;126578;102255;99714;24323;2541;24463;19960;22448;18442;4983;4861;1721;1178;932;521;205
5;5;HAUTES-ALPES;109907;89086;86927;20821;2159;18474;18948;18796;16645;5109;4938;1609;1049;783;411;165
6;6;ALPES-MARITIMES;761761;599858;587932;161903;11926;163141;111953;87941;161036;21067;25175;5262;3622;6067;1729;939
7;7;ARDECHE;249258;202640;195556;46618;7084;45305;42320;42622;33835;11757;9926;3546;2602;1969;1303;371
8;8;ARDENNES;194379;150303;146803;44076;3500;47578;26912;26172;25273;7234;7810;1406;1693;1080;1378;267
9;9;ARIEGE;117409;96017;93306;21392;2711;20247;19523;24970;11892;7326;3369;3304;1180;799;556;140
10;10;AUBE;203847;164896;161068;38951;3828;48846;30565;22496;37122;6545;10235;1159;1387;1317;1107;289
11;11;AUDE;272695;220142;214361;52553;5781;60585;43015;46126;32281;13614;8265;4642;2507;1783;1195;348
12;12;AVEYRON;218276;181898;176463;36378;5435;28588;45584;34689;36664;10878;8554;6461;2322;1304;1106;313
13;13;BOUCHES-DU-RHONE;1372394;1072248;1049698;300146;22550;286397;203312;231194;207466;47564;40447;10040;8006;9418;4114;1740
14;14;CALVADOS;501153;410840;401622;90313;9218;81770;99720;75620;82340;27293;20079;2911;5269;2830;3099;691
15;15;CANTAL;117425;94658;91566;22767;3092;16641;24477;14566;21589;4810;4047;2840;1179;527;692;198
16;16;CHARENTE;259954;204974;199013;54980;5961;42598;49889;40755;33744;12569;10008;3085;2724;1540;1651;450
17;17;CHARENTE-MARITIME;491369;392018;382065;99351;9953;80764;91355;72491;78659;22023;20333;5276;4876;3020;2576;692
18;18;CHER;228983;178073;172686;50910;5387;41753;38076;33694;32967;9157;9554;1925;2106;1479;1630;345
19;19;CORREZE;185277;150978;145613;34299;5365;25253;39218;30357;25427;9263;7049;4253;2319;1094;1051;329
20;21;COTE-D'OR;360658;291978;285124;68680;6854;64200;67436;50859;60625;16810;14980;2635;2818;2457;1795;509
21;22;COTES-D'ARMOR;455958;384341;374969;71617;9372;61703;104969;76013;68916;32260;15958;3554;5468;2479;3028;621
22;23;CREUSE;93113;73196;70251;19917;2945;13966;15807;14827;12637;5494;3521;1352;1209;580;684;174
23;24;DORDOGNE;314020;256500;248710;57520;7790;52044;55945;57132;42510;15783;11424;6050;3578;2128;1626;490
24;25;DOUBS;368401;292202;284179;76199;8023;66635;63954;50803;59929;16318;14733;2532;3565;3129;2051;530
25;26;DROME;369489;296279;288741;73210;7538;68996;63164;58037;53403;17385;14997;3868;3174;2988;2196;533
26;27;EURE;427533;345318;336777;82215;8541;98719;66986;58844;63436;16999;19096;2602;3933;2927;2633;602
27;28;EURE-ET-LOIR;301466;240992;234779;60474;6213;58886;51038;38035;51275;12317;14103;1942;2659;2253;1817;454
28;29;FINISTERE;690571;569935;557185;120636;12750;77366;164095;109607;99965;60781;22737;6192;8250;3697;3638;857
29;30;GARD;537939;430662;420682;107277;9980;123273;79006;90905;72366;20473;17808;5946;4044;4096;2092;673
30;31;HAUTE-GARONNE;906653;735868;719393;170785;16475;120225;190128;170446;118608;60180;27833;14445;7116;5955;3166;1291
31;32;GERS;144959;121932;118683;23027;3249;23387;27775;23089;21312;9527;5378;5059;1254;1037;677;188
32;33;GIRONDE;1086982;870380;850820;216602;19560;155319;222287;185888;145283;64300;35530;16460;13233;7013;3980;1527
33;34;HERAULT;800394;641024;626844;159370;14180;161119;128621;143996;110339;36180;23159;8461;5660;5919;2496;894
34;35;ILLE-ET-VILAINE;730142;613437;599341;116705;14096;84648;181373;118096;114034;53418;26822;4531;7065;3994;4339;1021
35;36;INDRE;170409;135498;130934;34911;4564;31985;27301;24938;25476;7786;7177;1728;1757;1098;1390;298
36;37;INDRE-ET-LOIRE;428871;348700;339905;80171;8795;64522;83165;65931;72196;22898;18452;2929;3907;2620;2606;679
37;38;ISERE;856366;678362;662514;178004;15848;147910;164091;135949;112927;43652;33773;6537;6382;6558;3595;1140
38;39;JURA;190332;153808;149569;36524;4239;36110;31896;30331;28373;7589;8533;1994;1980;1330;1148;285
39;40;LANDES;310197;254786;247866;55411;6920;44956;61043;49949;42464;21550;11021;10485;2875;1916;1235;372
40;41;LOIR-ET-CHER;245321;198996;193738;46325;5258;48662;40639;31576;42756;10956;11646;1843;2198;1516;1542;404
41;42;LOIRE;510809;401971;391367;108838;10604;94222;90677;73388;71848;22698;22689;5041;4107;3483;2547;667
42;43;HAUTE-LOIRE;177158;144283;139577;32875;4706;32185;32821;25419;25956;7435;8346;3112;1928;1050;1043;282
43;44;LOIRE-ATLANTIQUE;993538;830941;811457;162597;19484;111194;232602;178357;159703;65140;36546;6029;9618;6129;4785;1354
44;45;LOIRET;452607;364633;355572;87974;9061;83662;83506;58134;75655;20438;21128;3203;3655;3109;2380;702
45;46;LOT;136322;113975;110787;22347;3188;17865;29527;26014;18459;7951;4550;3073;1528;871;723;226
46;47;LOT-ET-GARONNE;240931;194126;188822;46805;5304;47271;39253;36018;34828;10639;9407;6083;2292;1660;1044;327
47;48;LOZERE;59508;49559;48147;9949;1412;9097;10463;9483;10986;2733;2197;1764;683;354;294;93
48;49;MAINE-ET-LOIRE;569425;472387;458958;97038;13429;77935;121685;78293;108888;29553;25321;3483;5696;3439;3860;805
49;50;MANCHE;379104;308902;300446;70202;8456;61620;74683;51026;64909;19238;17052;2520;4134;2048;2593;623
50;51;MARNE;381696;300431;293769;81265;6662;82473;60958;44424;65081;13683;16896;2350;2762;2441;2176;525
51;52;HAUTE-MARNE;134148;105379;102440;28769;2939;34027;18438;15380;19590;4292;6417;1126;1233;813;926;198
52;53;MAYENNE;222325;185933;180232;36392;5701;30465;46938;26798;48772;10247;10107;1525;2242;1182;1627;329
53;54;MEURTHE-ET-MOSELLE;495091;388596;379766;106495;8830;98194;83703;77400;62654;23632;19331;3236;4483;3458;2942;733
54;55;MEUSE;137629;109780;107045;27849;2735;34602;20713;16020;19287;4918;6802;1294;1430;856;886;237
55;56;MORBIHAN;577012;480899;468835;96113;12064;82927;130639;82020;97900;34368;22411;4820;6309;3249;3291;901
56;57;MOSELLE;751271;573771;559217;177500;14554;158542;117738;100118;96003;29480;32525;5763;6975;5977;4929;1167
57;58;NIEVRE;159425;123968;120434;35457;3534;29817;27356;23079;20773;7854;6446;1365;1547;959;1004;234
58;59;NORD;1804668;1387595;1353803;417073;33792;382030;268723;288115;226710;76531;65245;8535;13151;11450;10975;2338
59;60;OISE;562085;448831;437793;113254;11038;135188;86680;77415;76783;20525;23936;3414;4682;4666;3677;827
60;61;ORNE;208734;170394;166057;38340;4337;39532;35815;24542;41084;8659;9644;1480;2147;1291;1513;350
61;62;PAS-DE-CALAIS;1090368;856174;833152;234194;23022;286147;153682;159342;119077;43084;41427;5832;9002;5484;8667;1408
62;63;PUY-DE-DOME;460939;367576;356567;93363;11009;63030;96797;78417;58432;25814;15635;7348;4730;2910;2699;755
63;64;PYRENEES-ATLANTIQUES;502378;405021;395653;97357;9368;54376;103958;78803;71858;30589;14727;29882;6371;2782;1799;508
64;65;HAUTES-PYRENEES;177690;143415;139689;34275;3726;25947;35070;32148;20220;9935;5876;6928;1575;1023;767;200
65;66;PYRENEES-ORIENTALES;347914;273930;266787;73984;7143;80169;49245;56392;45865;13455;9741;4634;3053;2303;1477;453
66;67;BAS-RHIN;766539;612502;598105;154037;14397;147714;133347;88420;131564;31931;39299;6420;6549;6841;4823;1197
67;68;HAUT-RHIN;526190;415694;403910;110496;11784;109704;79798;57856;90237;18694;28562;5004;4727;5217;3101;1010
68;69;RHONE;1155604;906531;888512;249073;18019;144476;236137;175051;205781;60094;38429;6703;7146;9188;4061;1446
69;70;HAUTE-SAONE;179214;144238;139522;34976;4716;43753;27332;22150;25184;6596;8176;1512;2021;1206;1325;267
70;71;SAONE-ET-LOIRE;406418;319634;309951;86784;9683;75258;69212;55249;60100;19184;18961;3153;3588;2535;2201;510
71;72;SARTHE;405440;331863;322444;73577;9419;67083;64618;56851;92261;17195;13657;2141;3565;2074;2452;547
72;73;SAVOIE;310237;247491;241559;62746;5932;52448;55871;45013;50815;13752;13673;3152;2578;2608;1219;430
73;74;HAUTE-SAVOIE;540033;423758;413498;116275;10260;77919;100174;67079;105057;21805;24785;4649;4263;5021;1919;827
74;75;PARIS;1301637;1091437;1076559;210200;14878;53719;375006;210548;284744;109550;17997;5490;6799;8337;2897;1472
75;76;SEINE-MARITIME;881658;704364;686526;177294;17838;170945;145756;152394;118336;41516;33036;4383;8321;5205;5356;1278
76;77;SEINE-ET-MARNE;881558;698256;680591;183302;17665;155521;157314;141827;120968;38772;41505;5182;6354;8195;3706;1247
77;78;YVELINES;951148;773663;758934;177485;14729;98024;219063;126345;206835;52564;32906;5371;5448;8148;2872;1358
78;79;DEUX-SEVRES;272385;221229;214398;51156;6831;38640;57826;41609;40195;14950;11356;2599;3483;1478;1869;393
79;80;SOMME;409014;328525;319636;80489;8889;97081;69520;59491;51834;14260;15462;2365;3661;2272;3111;579
80;81;TARN;291194;240687;233757;50507;6930;52402;51755;48094;41052;15530;11440;7105;2721;1822;1397;439
81;82;TARN-ET-GARONNE;183341;150718;146801;32623;3917;39183;30319;27841;25992;8567;7233;3660;1573;1337;830;266
82;83;VAR;794777;625670;612438;169107;13232;186376;108597;94184;152316;21089;29177;6933;4655;5860;2274;977
83;84;VAUCLUSE;402323;321721;314228;80602;7493;95930;58208;60852;59619;13553;14452;3989;2804;2890;1388;543
84;85;VENDEE;514442;431575;418830;82867;12745;77590;109989;63156;106804;21356;24211;3810;5219;2705;3294;696
85;86;VIENNE;307014;244887;237748;62127;7139;47024;59146;49061;42703;16861;11920;2861;3642;1896;2074;560
86;87;HAUTE-VIENNE;266322;215699;208415;50623;7284;37937;55577;46549;32522;16136;9285;3518;3044;1557;1850;440
87;88;VOSGES;282612;226219;219502;56393;6717;63924;43604;36524;39579;10887;14323;2750;3229;2223;2004;455
88;89;YONNE;241918;189179;184553;52739;4626;52640;36234;30815;36739;8846;11668;1987;2128;1775;1380;341
89;90;TERRITOIRE DE BELFORT;95290;73652;71574;21638;2078;19249;14771;13672;12668;4189;3770;669;886;941;592;167
90;91;ESSONNE;795227;637787;623487;157440;14300;102461;163389;136392;112478;42072;44793;4468;5755;7514;2924;1241
91;92;HAUTS-DE-SEINE;986730;810015;794758;176715;15257;60731;256687;145289;231553;57114;21359;4747;5033;8453;2447;1345
92;93;SEINE-SAINT-DENIS;766894;555942;541202;210952;14740;73534;130103;184123;69063;45506;16601;3160;6050;8739;3235;1088
93;94;VAL-DE-MARNE;785540;621472;607787;164068;13685;69878;172202;149112;122814;47228;26252;3957;5226;7303;2749;1066
94;95;VAL-D'OISE;730497;562937;548138;167560;14799;94158;138752;131342;101131;37518;24790;3975;5040;7702;2752;978
95;2A;CORSE-DU-SUD;108781;75023;72868;33758;2155;20858;13022;10085;18714;2546;2218;3948;657;485;218;117
96;2B;HAUTE-CORSE;124875;83968;81508;40907;2460;22183;15506;11229;20739;3234;2244;4763;717;480;277;136